#@#######################################
#.........#.......#.....#.........#.....#
#.#######.#.###.#.###.#.#####.###.#.#####
#.#.....#...#.#.#.....#.......#.#.#.....#
#.###.#.#####.#.###.###########.#.#.###.#
#...#.#.#.....#.#...#...........#.#...#.#
###.#.#.###.#.#####.#####.#.###.#.###.#.#
#.#.#.#.....#.....#...#...#...#.#...#.#.#
#.#.#.#######.###.###.#.#####.#####.###.#
#...#...#.#...#.#...#.#.....#.....#...#.#
#.#####.#.#.###.###.#######.#.#.#####.#.#
#.......#.........#.........#.#.........#
#######################################$#